R	720 720

NO	textures/jolane.xpm
SO	textures/ghalem.xpm

WE	textures/levekteur.xpm
EA	textures/teofile.xpm

S1	textures/Bietrix.xpm
S2	textures/so6.xpm

F	100,	100,	100
C	50,		50,		50

11111111111111111111111111111
       1000000000001111111111
11111111001100000000000000001
101100000111 0000010020011001
100100N00000002000300000010011
10110000011110000000000011001
10000000001100000111101111001
111100000000000111000000100011
111101330020300011101010010001
110000001202010111000002100001
10001000000000001100020010001
10000000000000001101010010001
11000000110101011111111111111
11111111111101111111111111111
11111111111111111111111111111
