R 1280 720
NO textures/bluestone.xpm
SO textures/eagle.xpm
WE textures/greystone.xpm
EA textures/colorstone.xpm
S  textures/barrel.xpm
F 94, 201, 247
C 83, 104, 173
11111111111111111111111111111
       1000000000001111111111
11111111001100000000000000001
101100000111 0000010020011001
100100N00000002000200000010011
10110000011110000000000011001
10000000001100000111101111001
111101111111110111000000100011
11110111111111011101010010001
110000001101010111000002100001
10001000000000001100020010001
10000000000000001101010010001
11000000110101011111111111111
11111111111101111111111111111
11111111111111111111111111111