R 1280 720
NO cub3D/sample.cub
SO cub3D/sample.cub
WE cub3D/sample.cub
EA cub3D/sample.cub
S  cub3D/sample.cub
F 220,100,0
C 225,30,0
       111111111111111111111111
       10000000000000000000001
11111111001100000000000000001
10110000011110000010000011001
100100N000002 2000000000010001
10110000011110000000000011001
10000000001100000011101111001
11110111111111011100000010001
11110111111111011101010010001
11000000110101011100000210001
10001000000000001100020010001
10000000000000001101010010001
11000000110101011111011110001
11110111111101010111011110001
11111111111111111111111111111