R 1280 720
NO textures/eagle.xpm
SO textures/blueeagle.xpm
WE textures/bluebrick.xpm
EA textures/redbrick.xpm
S  textures/cage.xpm
F 100, 100, 100
C 50,50,50
11111111111111111111111111111
       1000000000001111111111
11111111001100000000000000001
101100000111 0000010020011001
100100E00000002000200000010011
10110000011110000000000011001
10000000001100000111101111001
111101111111110111000000100011
11110111111111011101010010001
110000001101010111000002100001
10001000000000001100020010001
10000000000000001101010010001
11000000110101011111111111111
11111111111101111111111111111
11111111111111111111111111111