R 500 500
NO textures/bluestone.xpm
SO textures/eagle.xpm
WE textures/greystone.xpm
EA textures/colorstone.xpm
S  textures/barrel.xpm
F 94, 201, 247
C 83, 104, 173
       111111111111111111111111
       10000000000000000000001
11111111001100000000000000001
10110000011110000010000011001
100100W000002 2000000000010001
10110000011110000000000011001
10000000001100000111101111001
11110111111111011100000010001
11110111111111011101010010001
110000001101010111000002100001
10001000000000001100020010001
10000000000000001101010010001
11000000110101011111011110001
11110111111101011111011110001
11111111111111111111111111111